    EA ./PNGs/ecole.png
    NO ./PNGs/catmeow.png            
    SO ./PNGs/bitcoin.png 
    WE ./PNGs/women.png


F 43,0,16
    C 0,0,0





        1111111111111111111111111
        110000001100000000000011
        1011000001110000000100001
        1001000000000000000000011
111111111011000001110000000000001
1000000000110000001110111111111111
11110111111111011100000010001
11110111111111011101010010001
11000000110101011100000010001
10000000000000000000000010001
10000000000000000010000010001
10000000000000000100000010001
10000000000000000000000000011
1100000101010101111101111000W11
1111011101110101 101111010001
1111111101111111 111111111111
1000000001
1111111111
