EA ./PNGs/ecole.png 
NO ./PNGs/catmeow.png            
SO ./PNGs/bitcoin.png 
WE ./PNGs/women.png 
F 0,0,0
C 43,0,16 


11111111111111111111111111111
10000000001100000111011110001
10110000011100000000000010001
10010000000000001100000010001
10110000011101000000000010101
10000000001100000111011110001
11110111111111011100000010001
11110111111111011101010010001
11000000110101011100000010001
10000000000000001100000010001
10000000000000001101010010001
11000000110101000000000000001
11110111110101000000000000001
10000000001100000100100010001
1000N000000000001010000101001
10100000001000010001010001001
10000000001101000100100100101
10000000000100000001010000001
11111111111111111111111111111