EA ./PNGs/ecole.png 
NO ./PNGs/catmeow.png            
SO ./PNGs/bitcoin.png 
WE ./PNGs/women.png 
F 0,0,0
C 43,0,16 


11111111111111111111111111111
10000000001100000000000000001
10111111011111111111111111101
10010001010000000000000000101
10110001011111011111111110101
10110001010000000000000110101
10110001010111111111110110101
10110001010000000000000N10101
10110001011111111111111110101
10010001010000000000000000101
10111111011111101111111111101
10000000000000000000000000001
11111111111111111111111111111