EA ./PNGs/ecole.png 
NO ./PNGs/catmeow.png            
SO ./PNGs/bitcoin.png 
WE ./PNGs/women.png 
F 0,0,0
C 43,0,16 


11111111111111111111111111111111111111111111111111111111111111111111111111111111111
1N000000001111111111100000000000000000000001111111111111111111110000000000000000101
10111111011111111111101111101111111111111111111111111111111111111111111111111110101
10010001000000000000100000100000000101000101000000000000000100000000101000000010101
10110001011111011111111110101111110101001101011111111111111110111111111101011110101
10110001010000000000000110101111110101011101011111111111111110111111111101011110101
10110001010111111111110000101111110001011101011111111111111110111111111111111111111
111111111111111111111111111111111111111111111111111111111111111